##########
#S####p###
#pppp#p###
#p####p###
#pppppp###
##########
##########
##########
##########
#p########
----
