############
#S####p###p#
#pppp#p###p#
#p####p###p#
#pppppp#####
############
############
############
############
#p##########
----
